X03.....................
F02.....................
........................
.............ggggggggg..
.............g.......g..
..K01........g.G.....g..
.............g.0.....g..
.....g.g.....g.5.....g..
.....gkg.....g.......g..
...gggkggg...g....x..g..
...g..k..g...g.......g..
...g.....g...ggggggggg..
...g..f..g..............
...g.....g..............
