X03.....................
F02.....................
........................
.............ggggggggg..
.............g.......g..
..B01........g.G.....g..
.............g.0.....g..
.....g.g.....g.5.....g..
.....gbg.....g.......g..
...gggbggg...g....x..g..
...g..b..g...g.......g..
...g.....g...ggggggggg..
...g..f..g..............
...g.....g..............
