.........
.B02.....
.S03.....
......b..
..s......
