B02..X03
........
........
.b....d.
........
...D....
........
......0X
