........
...B02..
........
.0......
.3..b...
........
........
........
