B02...03
........
........
.....X..
.b....x.
........
........
........
