B02..X03
........
...pp...
..p.xp..
..p..p..
...pp...
.b......
.....P01
