B03..X02
........
.b....x.
........
........
.s....c.
........
S03..C02
