........................
........................
.........aaaaaaaa.......
.........a......a.......
.........aW0....a.......
.........a..3...a.......
.....aaaaa......a.......
.....a..........a.......
.....a.....w....a.......
.....a..........a.......
.....aaaaaaaaaaaa.......
.........a......a.......
......N..a.A....a.......
......0..a.0..n.a.......
......2..a.4....a.......
.........a......a.......
.........aaaaaaaa.......
........................
