.................
.................
.................
...P02.....C04...
...ccccccccccc...
........d........
.....p..d..s.....
........d........
...ccccccccccc...
...D01.....S03...
.................
.................
.................
