P04.p.......l...........
L05.p.......l..mmmmm....
....p.......l..m...m....
H03.p...c...l..m.h.m....
....p.......l..m...m....
ppppp.......l..mmmmm....
............l...........
............llllllllllll
........................
........................
........................
........C...............
..M04...0...............
........2...............
