G02.....
F03.....
C01..f..
........
cccc....
...c....
.g.c....
...c....
