.................
.................
.................
...C02.....P01...
...ppppppppppp...
...p....s....p...
...p.c..s..d.p...
...p....s....p...
...ppppppppppp...
...S05.....D03...
.................
.................
.................
